#############
#####0000000#
#0000000#####
#####0000000#
#000000######
#####0000000#
#0000000#####
#####0000000#
#000000######
#####0000000#
#0000000#####
#####0000000#
#000000######
#####0000000#
#0000000#####
#####0000000#
#000000######
#0000000#####
#####0000000#
#0000000#####
#####0000000#
#000000######
#0*000000000#
#############