################################################################
000000000000000000000000000000000#000000###00000000000000000000#
0000000##0000000##0000000000000#0#0#00000#00#0000###############
0*00##00000##0000000000###00000#000#0000000###000000000000000000
################################################################