#############
#00000000000#
#0000*000000#
#00000000000#
#00000000000#
#00000000000#
#00000000000#
#00000000000#
#00000000000#
#00000000000#
#00000000000#
#00000000000#
#00000000000#
#00000000000#
#00000000000#
#00000000000#
#00000000000#
#00000000000#
#00000000000#
#00000000000#
#00000000000#
#00000000000#
#00000000000#
#00000000000#
#00000000000#
#00000000000#
#00000000000#
#00000000000#
#00000000000#
#00000000000#
#00000000000#
#00000000000#
#00000000000#
#00000000000#
#00000000000#
#00000000000#
#00000000000#
#00000000000#
#00000000000#
#00000000000#
#00000000000#
#00000000000#
#00000000000#
#00000000000#
#00000000000#
#00000000000#
#00000000000#
#00000000000#
#00000000000#